NO ./assets/wall_no.xpm
SO ./assets/wall_so.xpm
		
F 98,70,33
C 77,159,240

WE ./assets/wall_we.xpm
EA ./assets/wall_ea.xpm
11111111111111111
            100000000000000010000000111111                      
               111111100S00000010000000000001          
            100000000000000000000000000001              
100000000000001111111111000001
     100000000000001110000000000001           
111000000000001110000000000001
    100000000000000000000000000001          
100000000000000000000000000001
100000000000010000000000000001
        100000000000000000000000000001
10000000000                       0000000000000000001        
100000000000000000000000000001
1000111111111111                    11111111110001               
100000000000000000000000000001
            100000000000000000000000000001
111000000000111111111111111111
1111111111111111111111111111111
11
1
1
1111111







